2222222222
2301111002
2021111202
2111211212
2121111112
2111111212
2111111112
2021211202
2401111002
2222222222