22222222222222222222222222222222
20111100000001011111000001111312
23111102211100000001011011011012
20000000000000000000012011011012
21101102201101020001011012011012
21101101101100000001011011011012
21100110001101020101011021011012
20001110122201020100000011000012
21101110102101020112220221011012
21101110102101020112000000011012
20000001102101010222110112011012
20101100002201010000000012011012
20101111111201011011110112011412
20101000011201011011000222000012
20102220111201011011010111011012
20101100111101011011122211011012
20000000001111010000011111000012
22222222222222222222222222222222
