2222222222
2300000002
2020000202
2000200202
2020000002
2000000202
2000000002
2020200202
2300000002
2222222222