2222222222
2000300002
2000000002
2000500002
2001410002
2000100002
2000000002
2000300002
2000000002
2222222222